The ouput is a maze running from left to right.

###############
              #
############# #
#           # #
# ######### # #
# #       # # #
# # ##### # # #
# # #   # # # #
# # # ### # # #
# # #     # # #
# # ####### # #
# #         # #
# ########### #
#             #
###############
